20
.o..................
.o..................
................o...
.o..................
........o...........
..o.............o...
..................o.
.........o..........
..........o.........
......o.............
.................o..
.....o..............
..o.................
..o.................
...........o........
.................o..
..................o.
o...................
.........o..........
o...................
